b8c9c9aaac
943675bc96
559aa6943c
553c9a43e5
53e53c59a4
3aa2a673c5
9ac98aac55
5d5559a655
534555b847
3e5753a63e
9c5969c9ac
5361a63694
5d92ae9a65
532e9a69c5
3aaa6ba636

1,9
9,9
